W W W W W W W W W W W W
W E H C H - - - - S - W
W - H - H K W W - - - W
W - H - W W - - - B - W
W - - - - W - W - - - W
W W W W - W - W - - - W
W - - - - W - W - - - W
W - H W W W - W - - - W
W - H - H - - W - - - W
W - - - - - - W - P - W
W - - H - H - W - - - W
W W W W W W W W W W W W