W W W W W W W W W W W W
W E H C H - - - - - - W
W - H - H K W W - - - W
W - H - W W - - - - - W
W - - - - W - W - - - W
W W W W - W P W - - - W
W - - - - W - W - - - W
W - H W W W - W - - - W
W - H - H - - W - - - W
W - - - - - - W - - - W
W - - H - H - W - - - W
W W W W W W W W W W W W