W W W W W W W W W W W W
W E H C H - - - - - P W
W - H - H K W W - - - W
W - H - W W - - - - - W
W - - - - W - W - - - W
W W W W - W - W - - - W
W - - - - W - W - - - W
W - H W W W - W - - - W
W - H - H - - W - - - W
W - - - - - - W - - - W
W - - H - H - W - - - W
W W W W W W W W W W W W