W W W W W W W W W W W W W
W - - - - - B - - - S - W
W - - - - - - - - - - - W
W - S - - - - - B - - - W
W - - - - - - - - - - - W
W - - - - - - - - - - - W
W - - B - - - S - - - - W
W - - - - - - - - - P - W
W S - - - - - - - - - - W
W - - - - - - - - - - - W
W - - - S - - B - - - - W
W W W W W W W W W W W W W